.....#......
.....##..#..
......#.....
..#.......#.
...........#
.....#..##.#
#.........##
#..##......#
..#.........
\robot 0 6
\robot 0 0