.##.#......
......#....
#.A........
#..#.......
#.....#.#..
....#......
...#.......
...#.......