.....#......
.....#####..
......#..#..
..#.......#.
............
.....#..##.#
#.........##
#..##......#
..#.........
\robot 8 8
\robot 11 6